######
##.@ #
# $$ #
#.   #
######

